wwwwwwwwww
w0p0wb000w
wb000g00ww
wwb0wb000w
ww00bb0b0w
w00000b00w
w00w00w00w
w00bw0000w
w0b000bb0w
wwwwwwwwww

