wwwwwwwwww
w000wb000w
wb0bw0000w
wwb0wb000w
ww00b00b0w
w0w000g00w
w00p00w00w
w00bw0000w
w0b000bb0w
wwwwwwwwww

