wwwwwwwwww
w000bb000w
wbb0w0000w
wwb0bb000w
wb00b0000w
w0p000000w
w00000w00w
w000w0000w
w0g000b00w
wwwwwwwwww

